P . . . . . . . . . . . . X . . . . . P
. . . . . . C . . . . . . . . . . . . .
. . . . . . . . . . . . . . . . . . X .
. C . . . . . . . . . . . . . . . . . .
. . . . . . . . . . . . . . . . . . . .
. . . . . . . X S . . . . . C . . . . .
. . C . . . . . . . . . . . . . . . . .
. . . . . . . . . . . . . . . . . . . . 
C . . . . . . . . . X . . . . . . . . .
P . . . . . . . . . . . . . . . X . . P
