P . . . . . . . . . . . . . . . . . . P 
. . . . . . . . . C . X . . . . . . . .
. . . . . . . . . . . . . . . . . . . .
. . . S . . . . . . . . . . . . . . . .
. . . . . . . . . C . . . . . . X . . .
. . . . . . . . . . . . . . . . . . . .
. . . . . . . . . . . . . . . . . . . .
. . . X . . . . . . . . . . . . . . . .
. . . . . . . . . . . . . . . . . X . .
P . . . . . . . . . . . . . . . . . . P
