P . . . . . . . . . . . . . . . . . C P
. . . . . . . . . X . . . . . . . . . .
. X . . . C . . . . . . . . C . . . . .
. . . . . C . . . . . . . . . . . X . .
. . . . . . . . . S . . . . . . . . . .
. X . . . . . . . . . . . . . . . . . .
. . . . C . . . . . . . . . . . . . . .
. . . . . . . . . . X . . . . X . . . .
. . . . . C . . . . . . . . . . . . X .
P . . . . . . . . . X . . . . . . . . P